11111111111111111111
11000VVVVVV000000001
11000000100000100001
11000000000000100001
11000001000000100001
11001111000000100001
11001111S00000100001
11001110000000100001
10000000000000100001
100000000100011000X1
100VVVVVVV0111100001
100000000001111VV001
100VVVVVVVVVVVVVV001
10000000000000000001
11111111111111111111