11111111111111111111
10011111111110000001
10011111100001100001
10011111100001V00001
10011111111X00V11101
1001111111100VVV1101
10000000111000V11101
10000000000000V00001
10000000000000V001S1
1011VVV11111VVVVV001
10001000000000V00001
100V0000000000V00001
10000000000000000101
10000000000000000001
11111111111111111111