11111111111111111111
10000000000000000001
1000000000000X000001
10000000000000000001
10000000000000000001
10000S00000000000001
11111100000000000001
11111100000000000001
11111110000000001001
111111V0000V00000001
111111V0000V00111001
111111V0000V00111001
10000000000000111001
10000000000000000001
11111111111111111111