11111111111111111111
1000000X000000000001
10100000011100000001
100000000111000000S1
10000000011110000V01
10000000000010000001
10000000000000000001
10000001111111000001
10000001111000000001
10000111111000000001
10000111111000000001
10010111000000000001
1000000000000000V001
10000000000000000001
11111111111111111111