V1111111111111111111
V0001000000010100001
VVV00000000011111001
V00000000000S1111001
V000V000000111111001
V0VVVVV0000111111001
V000V00000000X000001
V000V000000000000001
V000V000000000000001
V0000000000000110001
V00000000000VVVVV001
10000000000000000001
10000000000001110001
10000000000000000001
11111111111111111111