111111111V1111111111
1000000S0V0000000001
100000000V000000V001
100011110V0000000001
100011110VX000000001
10001111000000VVV001
10001111000000000001
10000000001100000001
10VVVVVVVVVVVVVV0001
10000000000000000001
100000VVVVV000000001
10000000000000000001
10000110000000000001
10000110000000000001
11111111111111111111