11111111111111111111
10000000000000000001
110000S0000000000001
11000000000000000001
11000000000000000001
100001111VVVVV000001
10000111100X00000001
10000111100000000001
11111111111111100001
11111010000000000001
11111000000000000001
11111000V00010000001
10000000000000000001
10000000000000000001
11111111111111111111