11111111111111111111
10000000000000000001
10000000000000000001
10000000000000000001
10000000000000000001
10000000000000000001
10000000000000000001
10000000000000000001
1000000000000000X001
10000000000000111111
100S0011111111111111
11111111111111111111
11111111111111111111
11111111111111111111
11111111111111111111