11111111111111111111
1000000000000000S001
10000000000000000001
10000000000000000001
1000000X000000000001
1000000000000V000001
10000000V0000V000001
1000000000000V000001
10000000V0000V000001
1000000000000V000001
1000000000100V0V0001
1000000000000V000001
100000000000VVVV0001
10000000000000000001
11111111111111111111