11111111111111111111
10000000000000000001
10000000000000000001
10000000000000000001
10011110000000000001
10011111111110000001
10011110001110000X01
10011110001110000S01
10000000010000V00001
10100000010000V00001
10100000010000V00001
100000VVVVVVVVV00001
10000000000000000001
10000000000000000001
11111111111111111111