11111111111111111111
10000000000000000001
10000000000001001101
10000000000001001101
10000111100001000001
10000111100001000001
100001111000010000S1
10000111100001000001
10000100000000000001
1011010000XV00000001
11110100000V00000001
11110000000000000001
1110000VVVVVVVVVV001
10000000000000000001
11111111111111111111