11111111111111111111
10000000000000011111
10001111111111111111
10000000000000011111
10000000000000011111
10000000000000011111
10000000000000011111
10000000000000001101
100S011000VV00000101
1011011000000110X101
10000000000000000101
100000000V0000000001
100000000V0000000001
100000000V0000000001
111111111V1111111111