11111111111111111111
1000S0VV000000000001
1000100000000000V001
1000000000100000V001
10000000X00000011001
10000V00000VVV011001
10000VVVVV0000000001
10000V01111110000001
100V0001111110000001
101V1111111110000001
100V0001111111000001
10000001111111000001
10VVVVV1111111000001
10000000000000000001
11111111111111111111