11111111111111111111
10000000000000000001
10000000000000000001
10000000000000000001
10000000000000000001
10000000000000000001
10000000000000000001
10000000111100000001
10000000111100000001
10000000111100000001
100S000011110000X001
11111111111111111111
11111111111111111111
11111111111111111111
11111111111111111111