11111111111111111111
1000000000000000V001
100VVVVVV00000000001
1000V000000000000001
1000V0000000001111S1
1000V000000000111101
1000V00000000V111101
1000V0000000V0111101
1000V0000000V0000001
1000V11X0000V0000001
1000V110000VV0000001
100VVVVVVVVVV0000001
10000000000000000001
10000000000000000001
11111111111111111111