11111111111111111111
10000000000000000001
1X00001111111VVVV001
1VVVVVVVVVVVVVVVV001
1000000S000000000001
10000000000000000001
10000000V00000000001
10000000V00000001001
10000000V00000000001
10000000V00000000001
10000000V11000000001
100000VVVVVVVVVV0001
10011111111000000001
10000000000000000001
11111111111111111111