11111V11111111111111
10000VV0000000000001
10000VV0000010000001
10000V00000010000001
10000V00000S10000001
10000V00000111111001
10111V00000111111001
10111V11111111111001
10111V000001V1111101
10111VVVVV01V1111101
1VVVVV00000111111101
1X000000000111111101
10010000000000000001
10000000000000000001
11111111111111111111