11111111111111111111
100010000000V0000001
100010000000V0000001
100010000000VS000001
10000000000001111001
10000000000001111001
10000000000001111001
10000000000001111001
100000X0000000000001
10000000000011000001
10VVVVVVVVVVV1000001
11100000100000000001
11100000000000000001
10000000000000000001
11111111111111111111