1111111V111111111111
10000000000000000001
1000000S100000000001
10111101100000011X01
10111100000V00000001
10111100000000011001
10111101010000000001
10000001000000010001
10000001000000010001
10001101000000010001
10001101000111110001
10000000000000010001
VVVVVV00000000000001
10000000000000000001
11111111111111111111