11111111111111111111
10000000000000000001
100000X0000001110001
VVVVVVVVVVVV0V110001
10000000000001V11001
10000000000000000001
10000000000000000001
10000000000011100001
10000000000011100001
10000111S00V11100001
10101111111V11111001
10000111000V00011001
10000000000000000001
10000000000000000001
11111111111111111111