11111111111111111111
1000000S000000000001
10000000100000000001
1000VV001000000V0001
1000VV001000000V0001
1001VV001000000V0001
1000XV001000000V0001
10000V00100000000001
10000V11111111111001
10000V11100001100001
10000V11100000000001
VVVVVVVV1000V0000001
10000000000000000001
10000000000000000001
11111111111111111111