11111111111111111111
10000000000000000001
11000000000000000001
10000000000000000011
10000000011100000011
10000X00011100000001
10VVVVVVVV1100000001
1000V000000000000001
1000V000000000000001
1000V000000111110001
1000V000011100000001
10000000000000000001
10000000000000000001
100000S0000000000001
11111111111111111111