11111111111111111111
10000000011000000001
100000000000000S0001
1000V000000000010001
1000V000000000000001
10001000000000000001
10001000000000000001
1000100000000000V001
10X0100000000000V001
1000000000001110V001
10000011000000001001
11V00011111111111001
10000000000000000001
10000000000000000001
11111111111111111111