11111111111111111111
100VVVVVVVVVVV000S01
10000000000000000001
10000000000000000001
10000000000000000001
100000VVVV0000V00001
10V0001000000XV11001
10V00010000000V11001
10V01111000000V11001
10V01111000VVVVVV001
10001111000000V00001
10001111000VVVVVV001
1000000000000VVVV001
10000000000000000001
11111111111111111111