11111111111111111111
10000000000000000101
10000000000000000001
1000VVVVVVVVV0000001
10000000000000000001
100S0000000000000101
10000000000000000001
1V111100000000000001
VVVVV100000000000001
1V111100000000000001
101111000V0000000001
100000000V0110000001
100000000V0110000001
100000000V00000000X1
11111111111111111111