11111111111111111111
10001111111VVVV00001
100011111110000000X1
10001111111000111001
10001111VV1000111001
10001111111000111001
10000111111000000001
10000000000000000001
100000000S0000000001
10000000000000000001
1001VVVVVVVVVVV00001
10000000V00010000001
10VVV000100000000001
10000000000000000001
11111111111111111111