11111111111111111111
10000000000000000001
10000000000000000001
10000000000000000001
10000000000000000001
10000000000000000001
10000000000000000001
10000000000000000001
10000000000000000001
10000000222200000001
100S0000022000000001
10000000022000000001
10000000022000000001
10000000022000X00001
11111111111111111111