11111111111111111111
10000000000000001001
100000001110S0001001
1X000000000000001001
10000000000000011001
100000100000VVVV1001
10000000000000001001
100VVVVV000011001001
10000000000111101001
10100000000111101001
10000001111111101001
10000000000111100001
10010000000000000101
10000000000000000001
11111111111111111111