11111111111111111111
1S011111000000000001
10011111000000000001
10011111000000000001
10011111111111111001
10000000000000000001
100V0000000VVVVV0001
100V0000000001100001
100V0000000000000001
100V1110000000000001
1000111X000000000001
10001110000000000001
10VVVVVVVVVVVVVVV001
10000000000000000001
11111111111111111111