11111111111111111111
10000000000000000001
10000000000000000001
10000000000001000001
1000VVVV0000V0000001
100000000000V0000001
100000S01111V1111001
100V00000000V0000001
100V0000000000VV0001
100V00000V0000000001
100V00000V0000010001
100V11111V1110000001
100X0000000000000001
10000000000000000001
11111111111111111111