11111111111111111111
10000000000000000001
10000000000000000001
10000000000000000001
10000000000000000001
10000000000000000001
10000000000000000001
10000000000000000001
10000000000000000001
10S00000000000000X01
11111111111111111111
11111111111111111111
11111111111111111111
11111111111111111111
11111111111111111111