11111111111111111111
1000S100000000000001
10000100000000000001
11000100000000000001
10000100000000000001
1000010X000000000001
10000100000000000001
1000010000V000000001
1000000001V000000001
1000000000V000000001
10001000000011000001
10000000000000000001
10000000000000000001
10000000000000000001
11111111111111111111