11111111111111111111
10000000000000000001
10000000000000X00001
10000000000000000001
10V00000000000000001
10000000000000000001
1000000V000000000001
1S00000V000000011001
1000000V000100011001
1000001V000000000001
1000000V000VVVV00001
1000000V000000000001
100000000000VVVVV001
10000000000000000001
11111111111111111111